+++++++++++++++++++++++++++++++++++++++++++++++++++
+               +                                 +
+  ++++++++++  +++++++++++++  +++++++  ++++++++++++
+          +                 +               ++  +
+  +++s+++  +++++++++++++  +++++++++++++++++++++  +
+  +     +  +           +  +                 +++  +
+  +  +  +  +  +  ++++  +  +  +++++++++++++  +++  +
+  +  +  +  +  +  +        +  +  +        +       +
+  +  ++++  +  ++++++++++  +  +  ++++  +  +  ++   +
+  +     +  +          +   +           +  +  ++  ++
+  ++++  +  +++++++ ++++++++  +++++++++++++  ++  ++
+     +  +     +              +              ++   +
++++  +  ++++++++++ +++++++++++  ++++++++++  +++  +
+  +  +                    +     +     +  +  +++  +
+  +  ++++  +++++++++++++  +  ++e+  +  +  +  ++   +
+  +  +     +     +     +  +  +     +     +  ++  ++
+  +  +  +++++++  ++++  +  +  +  ++++++++++  ++  ++
+                       +  +  +              ++  ++
+ ++++++             +  +  +  +  +++        +++  ++
+ ++++++ ++++++ +++++++++    ++ ++   ++++++++++  ++
+ +    +    +++ +     +++++++++ ++  +++++++    + ++
+ ++++ ++++ +++ + +++ +++    ++    ++    ++ ++ + ++
+ ++++    +     + +++ +++ ++ ++++++++ ++ ++ ++   ++
+      ++ +++++++ +++     ++          ++    +++++++
+++++++++++++++++++++++++++++++++++++++++++++++++++